NO ./assets/texture1.xpm
SO ./assets/texture2.xpm
WE ./assets/texture3.xpm
EA ./assets/texture4.xpm

F 32,32,32          
C 224,224,224

        1111111111111 11111111111
        100001110011010000000000001
        1010N10101110000010000001
        100101110000000000000001
111111111011000001110000000000001
100000000011000001110111110111111
11110111111111011100000010001
11110111111111011101010010001
11000000110101011100000010001
10000000001 10000001100000101
1000100000110001101010010001
11000001110101011111011110001
11110111 1110110101111010001
11111111 11111 11111111111111

